111111111111111111111111111
100000000000001000100000001
111011111111101010001011101
101010001000100011111110101
100010101101111110010000001
101111101001001011010111111
100000001011011000010100001
111111111000001010110101101
100000001111101010100001002
111011100000100010101111111
101010111110111110000000001
101010100000100011111111101
100000101101101001000010001
111011100111001101111010111
100010110000011001010010001
101110011111110011011011101
100100110101000111001000001
110001100101110001011111101
100100001101010111010001001
110111011001010100010101101
100001000011010101010101001
111101011010010001000101011
100001001010110111111101001
101011101010000100000001101
101010101011111101111100001
101000101010010100010111111
101110001010110111010000101
100011111010000001000101101
111110100011110111101100001
100010111001010000001111101
101010001100011111101000101
301000100001000000100010101
111111111111111111111111111
