111111111111111111311111111
100010000010000001010001001
101010111010111101010101101
101000100010100101010101001
101111101111101101010101011
100000100000101001000101001
111110110110101011111101101
101000010010001000100001001
101011111011111110101111011
101000010010000000001000001
101111010111011111111011111
100000010000010000000000001
111111011111110111110111101
100100000100000100010010001
101101111101110101111010101
100000100101100100000011101
111110101101001110111010001
110000101000011011101010101
100101101011110000100010111
101100000010100110101110101
100111011110101100000000001
101100010000001001111111101
101001110111101011010000101
101111000100001000010110101
111000011101111011000010001
100011110001001001111011111
101110000111011111001000001
101000111100001000011011101
101010000101011011000010101
101111110001000010011010001
101000011111010111001010111
100011000000010010000010001
111111111111111111111111121
