111112111111111111111111111
100000000000000000000000001
101111111111111111111111101
101000010000000000000000101
101011011111111111111110101
100010000000000000000010101
101111111111111111111010101
101000100000000000000010101
101010111111110111101110101
101010001000010100101000101
101010100011010110101010111
101011111001010010111010001
101010001101011000101010101
101010101001001110101010101
101010101011100000101010101
101010101010001111101010101
101010101000100000101010101
101010101111111110101010101
101010101000000010001010101
101010101011111011101010101
101010101110001000101010101
101010100000100010101010101
101010101111111110101010101
101010101000000000101010101
111010111101111111101010101
100010100000000000000010101
101110111111111111111110101
101000000000000000000010101
101011111111111111110110101
101000000000000000000000101
101111111011111111111111101
100000001000000000000001001
111111111111111111111011111
